###############
#     @       #
#     X       #
#             #
#             #
#             #
#             #
#             #
#             #
#             #
#             #
#             #
#             #
#             #
###############
